 *  **   *    * *  * * ****  *  *    * ** * * *         *                * **   
   *   **                ** * **    * ***    *   ** *      *  * *   *    ** *** 
  * * * * *  *    *** *     *  *   *       *   * **   **       *   *    ***     
* *    *   *  *** ***           * *      *****                 *** * *  *  **   
   * **       **     *   **  * * *      ** *   ** **     *   ***      ***  * ** 
 *   * *   *     *        *     * *     *         *      *     *    *     *  *  
  * *   **    * *   * *   ** * *     *  * **    ****        *********   *  *    
*   *   *        ** *****   *  * * *            *   * * **    **   * *    **    
*   *    * **    **** *     *        *     ***** *     * *****   *     **    ***
 ***  **    *       *       *  *    *  *            *      *  *  *  *   *  *    
 * *         * * * * ** *  * *      *   * *           *     ***   *          *  
  *    ****   **    *      **  **    **   *     *      * *         *     **    *
  * *        *  *  *       **   **  **  *    *     *    ***    *  ** **       * 
*   ** *  **     *     *  ***  * **   ***    * ***    *** ** *   *     ** * *   
 *      *     ** *   *   *  ***          *   **  *  *     *   *     ***   **    
    * * * ***  *   **   *   *** *      *   *    ** *      * *  * * * **  ****** 
 *   *   * **  * ** *    *  *  *      *   *  * *       *   * * *    * *     *   
      *    **  ** ***  *   *    **  ***  * *      **    *            *      **  
* * *       * *  *           * *        *  *     **  *  **    *  * * **   * * * 
 *          * * *    ***     *  *  *  **        **    ** * *     *  *  *    *   
  *   * ** * *     * *    *   **   **    * * *     *          *  * * *     * ** 
   *** **   **    *     * *       * *             * * **    *     *       ** *  
 **              * *       *    **  *  * *    *      *** *  *    **   *     *  *
   *  * * *  ***     *    *  * **  *    ***   *       *   * ******  * *         
***  *    ******  * *  *  *** * *  *             ** *  * *   * **  **   **      
