    **     **    * * ** *  *  * ** *  **  *   *  **    * *  ** **  **  *    ** *
** **  * *** *** **   *    ***   **  **   ***** * ***     ** *   *    **    * **
  *     *  **** *  *   * * *    **  * **** ***  * **  **   **   * ****    *   **
*  **  ****  **     ** ***      **  * ****     *    **   * * * * **  *      *   
 *     *  *   *  ** **  *    ** *  *** **   *** *** **  **   **    *    **    * 
*  *  **      *****     * *     ****    **  * **    **  *     *  ** *       *   
* ** * *     *   * * * *     *       *  * *     * * * * *****   *        *      
 **  *     * * ***** *** *           *** *** * * **** *   *     *  *  **   **** 
  ** * *    * * *    *****   * **   * *  **    *  *  **      *   *  *  ****** **
     *  * ** * * **        *       ***       **** * **** **  ** ** * **  **  ***
 **** *** *     *  * * **  * * * **    * **      *   **  * * * ***  *       * * 
  **  *  * * *       ***** *      *** ***     *        **  *******     * ***  * 
            * *  *** *      * ** *        *    **  **  * * ** *    *    *** *   
        *   **  ***   ****      * ** *** *      ***   * *   **    *        * *  
 *  *      ** * *** **      *** ***  * ****  * * *         * *     *** * **    *
**    ******    **  ****** ***   *  *     * * * *  *   *  * *   ** * *  *** ****
*      ** **** **  * *** * * **    *  ** * ***  **  *    *  ***  *    * *  ** **
*  ****    ** * *    *** ** **   **  *  *  *  **  *    *       * *** * **       
* *   *  ****      * ** ** *** ***    * *  **  * ***  * ***       *  ** *   *** 
      *  ** * * *   ** *   * *  *     *  * ** **  **  **     *** * *  **  *     
***  **  *         *        **   *   *        * ** *   *     ***  * ** *    *** 
 **   *   ***    **      **    *       *    **  *** ***** ** *  *   ** * * **** 
     * *   * **** * *   * * * * * **          **  *  ***  *  *  **  * *   *  *  
*   ** *  *   **     **  ****  **   * *   * *  * *  *   * * ****** **     **    
 *  *          *     *  ****      *** *   *        ****   **  **     *  ***  ** 
