  **           *  ***   **  ** *   * **        *    *  *** *    * ***  *   *****
 **  ***   **** * ******       * *  *  *  *   ** *  * * * *  *     *     * *    
*  * **  * *   *  *    ******  *   *   **** ** * *    * *    **   *  ***    ** *
    ***   *   *  **  ** *****  *        **        * *   * *    * *   ***  * **  
*        *     * **  **  * * *  *  *  * *    ** **  * **   *  *      **  *  *  *
   * *   * ** * * ** *     * *    ** *   *  *  **  ***      *  * * *         * *
** ** *        * *  * ** *   *     **  ***  *   ****  * **  *   *   *  ** * * * 
  *** *        *   *** *   ** *    *** *  *  *   **   * ** ** **         ** * * 
 *  *    *   **    **     *** * *** *     ***  *  *   ***  **   *** *  *   *    
   *    ****  *  *    ** *   **   **** * *   * * * *    *    *    **  ** *     *
 *   ***    *     * *   ***   **  **  *    *** **    ****** *  *  ** * ** * *  *
**  *      **  ** **   *         *  * **** * ***  * * *  ******* ** **  **   * *
* *       ** * *   *    ** *  * ** ****  **  ***    *****  *       *  *** * **  
  *             *  *  * * *   *  *  *   *   **** *** *   *    *        **  **  *
* *      *  *  **   **  **  *       **  *    ** ** *    *  * *         *    *   
* ****  *       *      **     ** ** **   **  ***   **      *    * *** *  **   * 
     ***     * ** * *** *  **** * *   *** * *   *       *  *   ****    ** *     
*   *     *      **  *** **         **   ********  **   * *  **     **      * **
*  *   **** **  *     *        ** **       ** ** ** *    **    **       ** *    
  **     ***                 ***  ***  * *    ** * * **       **    * *  *  ****
**       *   *   * ***** *  ****  ** *    ***  *** ***    ** * **  * *  *       
* *   *   *       ******   *       *  *     *    * *    *  **     ***  *** *   *
               *  **  *  ***      *  **** *    *  ****      *  * *** *  *  **  *
      *** *  * * **    ** **    *    ** **        *** **  ** * *  *  ***   *    
*      ** *  *  * *  ** *  *    ** *    * *  * *  * *   *    * **  * *  * * **  
